01,JAMMU & KASHMIR,99,Srinagar,UA,1273312,677260,596052,157100,84110,72990,797481,464086,333395,880,868,71.45,78.24,63.74
01,JAMMU & KASHMIR,21,Jammu,UA,651826,350035,301791,58424,31979,26445,528017,294652,233365,862,827,88.98,92.64,84.75
01,JAMMU & KASHMIR,99,Anantnag,UA,158785,82023,76762,26001,14013,11988,101256,56988,44268,936,855,76.26,83.79,68.34
02,HIMACHAL PRADESH,11,Shimla,UA,171817,94797,77020,13784,7291,6493,148775,83045,65730,812,891,94.14,94.90,93.20
03,PUNJAB,07,Ludhiana,City,1613878,874773,739105,173021,92492,80529,1230218,691161,539057,845,871,85.38,88.35,81.85
03,PUNJAB,15,Amritsar,UA,1183705,630114,553591,115368,63238,52130,904190,495804,408386,879,824,84.64,87.46,81.44
03,PUNJAB,03,Jalandhar,UA,873725,463975,409750,84886,45459,39427,674166,368174,305992,883,867,85.46,87.97,82.63
03,PUNJAB,14,Patiala,UA,445196,236238,208958,42458,22865,19593,348891,191651,157240,885,857,86.63,89.82,83.04
03,PUNJAB,12,Bathinda,City,285813,151782,134031,30713,16472,14241,211318,118888,92430,883,865,82.84,87.86,77.16
03,PUNJAB,18,S.A.S. Nagar,UA,176152,92407,83745,16148,8620,7528,148862,79486,69376,906,873,93.04,94.87,91.02
03,PUNJAB,04,Hoshiarpur,City,168443,88290,80153,16836,9178,7658,135094,72533,62561,908,834,89.11,91.68,86.30
03,PUNJAB,01,Pathankot,UA,159909,84145,75764,14734,8183,6551,128778,69945,58833,900,801,88.71,92.08,85.00
03,PUNJAB,08,Moga,UA,159897,84808,75089,16447,8850,7597,116800,64123,52677,885,858,81.42,84.42,78.05
03,PUNJAB,01,Batala,UA,158404,83536,74868,14943,8145,6798,122350,66809,55541,896,835,85.28,88.62,81.59
03,PUNJAB,09,Abohar,City,145238,76840,68398,15870,8587,7283,103319,58347,44972,890,848,79.86,85.49,73.59
03,PUNJAB,19,Malerkotla,City,135330,71401,63929,16315,8365,7950,83606,47164,36442,895,950,70.25,74.82,65.10
03,PUNJAB,07,Khanna,City,128130,67811,60319,13218,7232,5986,97022,53108,43914,890,828,84.43,87.67,80.82
03,PUNJAB,02,Phagwara,UA,117954,62171,55783,11622,6062,5560,92971,51022,41949,897,917,87.43,90.93,83.53
03,PUNJAB,10,Muktsar,City,117085,62005,55080,13639,7448,6191,79979,45007,34972,888,831,77.31,82.50,71.53
03,PUNJAB,20,Barnala,City,116454,62302,54152,12984,7096,5888,82347,46100,36247,869,830,79.59,83.51,75.10
03,PUNJAB,09,Firozpur,City,110091,58401,51690,11516,6262,5254,78615,43468,35147,885,839,79.75,83.37,75.69
03,PUNJAB,02,Kapurthala,City,101654,55485,46169,9706,5162,4544,78914,44399,34515,832,880,85.82,88.23,82.92
04,CHANDIGARH,01,Chandigarh,UA,1025682,563127,462555,113698,60902,52796,789436,455276,334160,821,867,86.56,90.65,81.55
05,UTTARAKHAND,05,Dehradun,UA,714223,377174,337049,72859,39047,33812,577303,315896,261407,894,866,90.01,93.43,86.21
05,UTTARAKHAND,13,Hardwar,UA,310562,165667,144895,36819,19697,17122,233857,131004,102853,875,869,85.43,89.75,80.50
05,UTTARAKHAND,13,Roorkee,UA,273502,148042,125460,32729,17866,14863,202946,117028,85918,847,832,84.29,89.90,77.69
05,UTTARAKHAND,11,Haldwani,UA,232060,121363,110697,27906,14817,13089,173874,94063,79811,912,883,85.17,88.28,81.77
05,UTTARAKHAND,12,Rudrapur,UA,154485,81527,72958,21443,11249,10194,99665,57368,42297,895,906,74.91,81.63,67.39
05,UTTARAKHAND,12,Kashipur,City,121610,63625,57985,14381,7792,6589,89433,49030,40403,911,846,83.40,87.82,78.61
05,UTTARAKHAND,05,Rishikesh,UA,102158,54466,47692,11507,6259,5248,78738,44453,34285,876,838,86.86,92.21,80.78
06,HARYANA,20,Faridabad,City,1404653,750446,654207,176773,95808,80965,1042168,592024,450144,872,845,84.88,90.44,78.53
06,HARYANA,18,Gurgaon,UA,901968,488808,413160,112094,60766,51328,680955,383441,297514,845,845,86.21,89.58,82.22
06,HARYANA,07,Panipat,UA,442277,237006,205271,56581,30579,26002,315317,180281,135036,866,850,81.75,87.33,75.33
06,HARYANA,03,Yamunanagar,UA,383318,205346,177972,40950,22450,18500,293475,163791,129684,867,824,85.72,89.55,81.32
06,HARYANA,14,Rohtak,City,373133,197754,175379,40715,22711,18004,279509,155679,123830,887,793,84.08,88.94,78.68
06,HARYANA,12,Hisar,UA,306893,166623,140270,34005,18268,15737,221498,127996,93502,842,861,81.17,86.28,75.08
06,HARYANA,06,Karnal,UA,303425,160659,142766,33321,18450,14871,232334,128508,103826,889,806,86.02,90.37,81.18
06,HARYANA,08,Sonipat,UA,292339,156246,136093,32932,18457,14475,226261,128216,98045,871,784,87.22,93.05,80.62
06,HARYANA,01,Panchkula,City,210175,111622,98553,22111,12024,10087,165235,90938,74297,883,839,87.86,91.31,83.98
06,HARYANA,02,Ambala,UA,207934,112840,95094,20687,11257,9430,167233,93215,74018,843,838,89.31,91.76,86.41
06,HARYANA,13,Bhiwani,City,197662,105372,92290,22507,12444,10063,147807,84028,63779,876,809,84.39,90.42,77.56
06,HARYANA,02,Ambala,City,196216,103533,92683,19645,10713,8932,155780,85004,70776,895,834,88.23,91.58,84.51
06,HARYANA,11,Sirsa,City,183282,96806,86476,20161,11161,9000,135435,75796,59639,893,806,83.03,88.50,76.98
06,HARYANA,15,Bahadurgarh,City,170426,91736,78690,20374,11420,8954,132108,75714,56394,858,784,88.04,94.27,80.87
06,HARYANA,09,Jind,City,166225,88561,77664,18825,10280,8545,123267,71129,52138,877,831,83.63,90.86,75.43
06,HARYANA,04,Thanesar,City,154962,83655,71307,15594,8401,7193,119482,67646,51836,852,856,85.73,89.89,80.85
06,HARYANA,05,Kaithal,City,144633,76657,67976,16690,9156,7534,103329,59162,44167,887,823,80.76,87.65,73.07
06,HARYANA,17,Rewari,City,140864,74689,66175,15986,8958,7028,110205,61933,48272,886,785,88.25,94.22,81.61
06,HARYANA,21,Palwal,UA,131121,69560,61561,16196,8903,7293,92964,53250,39714,885,819,80.89,87.79,73.18
07,NCT OF DELHI,99,Delhi,UA,16314838,8739213,7575625,1912253,1023534,888719,12448848,7025273,5423575,867,868,86.43,91.05,81.11
08,RAJASTHAN,12,Jaipur,City,3073350,1619280,1454070,378788,204320,174468,2272724,1282140,990584,898,854,84.34,90.61,77.41
08,RAJASTHAN,15,Jodhpur,UA,1137815,599332,538483,140703,74225,66478,807733,462139,345594,898,896,81.01,88.01,73.22
08,RAJASTHAN,29,Kota,City,1001365,529795,471570,118139,62958,55181,738795,422767,316028,890,876,83.65,90.56,75.90
08,RAJASTHAN,03,Bikaner,City,647804,340894,306910,82264,43280,38984,451663,259367,192296,900,901,79.86,87.15,71.77
08,RAJASTHAN,21,Ajmer,UA,551360,283340,268020,60701,32251,28450,428795,234020,194775,946,882,87.39,93.20,81.30
08,RAJASTHAN,32,Udaipur,UA,475150,246856,228294,49966,26724,23242,384481,210017,174464,925,870,90.43,95.41,85.08
08,RAJASTHAN,24,Bhilwara,City,360009,187952,172057,45832,24215,21617,264762,150306,114456,915,893,84.27,91.80,76.08
08,RAJASTHAN,06,Alwar,UA,341383,180680,160703,38359,20876,17483,261057,149433,111624,889,837,86.15,93.51,77.94
08,RAJASTHAN,07,Bharatpur,UA,252606,134348,118258,31617,17288,14329,181423,105814,75609,880,829,82.10,90.39,72.75
08,RAJASTHAN,01,Ganganagar,UA,250041,134435,115606,27850,15311,12539,183757,105504,78253,860,819,82.70,88.57,75.92
08,RAJASTHAN,13,Sikar,UA,244563,126964,117599,32967,17686,15281,163461,94468,68993,926,864,77.25,86.45,67.43
08,RAJASTHAN,20,Pali,City,229956,120008,109948,30566,16257,14309,156858,92705,64153,916,880,78.67,89.35,67.08
08,RAJASTHAN,22,Tonk,City,165363,84927,80436,23122,12280,10842,98819,57170,41649,947,883,69.47,78.70,59.85
08,RAJASTHAN,21,Kishangarh,City,155019,80343,74676,21765,11602,10163,106809,61313,45496,929,876,80.15,89.19,70.52
08,RAJASTHAN,21,Beawar,UA,151472,77882,73590,18406,9801,8605,114307,63648,50659,945,878,85.90,93.49,77.95
08,RAJASTHAN,02,Total Hanumangarh,City,151104,79817,71287,17947,9709,8238,104285,59883,44402,893,848,78.32,85.42,70.42
08,RAJASTHAN,08,Dhaulpur,UA,133229,71481,61748,18361,10075,8286,88107,51933,36174,864,822,76.70,84.57,67.66
08,RAJASTHAN,10,Gangapur City,UA,130030,68643,61387,17591,9502,8089,89712,53736,35976,894,851,79.79,90.86,67.50
08,RAJASTHAN,10,Sawai Madhopur,City,120998,63223,57775,15286,8170,7116,85472,50438,35034,914,871,80.85,91.62,69.16
08,RAJASTHAN,04,Churu,UA,120147,61936,58211,16368,8532,7836,77972,46198,31774,940,918,75.13,86.51,63.07
08,RAJASTHAN,05,Jhunjhunun,City,118966,61906,57060,16563,8887,7676,76183,44962,31221,922,864,74.40,84.80,63.22
08,RAJASTHAN,30,Baran,City,118157,61360,56797,14845,7842,7003,83879,48209,35670,926,893,81.19,90.08,71.64
08,RAJASTHAN,28,Chittaurgarh,City,116409,60229,56180,14067,7473,6594,86945,48624,38321,933,882,84.96,92.17,77.28
08,RAJASTHAN,14,Makrana,UA,116245,60080,56165,19504,10230,9274,63437,38039,25398,935,907,65.57,76.31,54.16
08,RAJASTHAN,14,Nagaur,UA,108540,56310,52230,14022,7461,6561,69065,40261,28804,928,879,73.07,82.42,63.07
08,RAJASTHAN,09,Hindaun,City,105690,56178,49512,15451,8345,7106,69108,41993,27115,881,852,76.58,87.79,63.94
08,RAJASTHAN,06,Bhiwadi,City,104883,59757,45126,16884,9080,7804,70987,44697,26290,755,859,80.67,88.20,70.44
08,RAJASTHAN,23,Bundi,UA,104457,54155,50302,12320,6558,5762,75778,42838,32940,929,879,82.24,90.00,73.96
08,RAJASTHAN,04,Sujangarh,City,101528,52078,49450,14723,7775,6948,64716,37914,26802,950,894,74.55,85.58,63.06
08,RAJASTHAN,27,Banswara,UA,101177,51941,49236,12337,6645,5692,77311,42036,35275,948,857,87.02,92.80,81.01
09,UTTAR PRADESH,33,Kanpur,UA,2920067,1584967,1335100,266336,143523,122813,2228473,1235685,992788,842,856,83.98,85.73,81.89
09,UTTAR PRADESH,26,Lucknow,UA,2901474,1518951,1382523,289375,152225,137150,2212850,1200843,1012007,910,901,84.72,87.86,81.26
09,UTTAR PRADESH,09,Ghaziabad,UA,2358525,1256783,1101742,308717,167038,141679,1922992,992243,930749,877,848,93.81,91.05,96.95
09,UTTAR PRADESH,15,Agra,UA,1746467,942441,804026,210036,117986,92050,992644,570593,422051,853,780,64.61,69.21,59.28
09,UTTAR PRADESH,66,Varanasi,UA,1435113,761060,674053,157482,83895,73587,1026032,573353,452679,886,877,80.31,84.67,75.39
09,UTTAR PRADESH,07,Meerut,UA,1424908,754857,670051,176770,95685,81085,977188,552000,425188,888,847,78.29,83.74,72.19
09,UTTAR PRADESH,44,Allahabad,UA,1216719,655734,560985,112023,59807,52216,950676,535385,415291,856,873,86.06,89.84,81.63
09,UTTAR PRADESH,19,Bareilly,UA,979933,522385,457548,104560,55307,49253,621228,350726,270502,876,891,70.97,75.09,66.25
09,UTTAR PRADESH,12,Aligarh,UA,909559,482828,426731,118778,63420,55358,557833,317990,239843,884,873,70.54,75.82,64.58
09,UTTAR PRADESH,04,Moradabad,City,889810,466432,423378,110376,57999,52377,550637,302447,248190,908,903,70.65,74.05,66.90
09,UTTAR PRADESH,01,Saharanpur,City,703345,371858,331487,88501,47024,41477,479218,265417,213801,891,882,77.94,81.71,73.72
09,UTTAR PRADESH,57,Gorakhpur,UA,692519,365148,327371,65078,34478,30600,537356,299268,238088,897,888,85.64,90.50,80.23
09,UTTAR PRADESH,10,Noida,CT,642381,352577,289804,83530,44493,39037,495045,286216,208829,822,877,88.58,92.90,83.28
09,UTTAR PRADESH,16,Firozabad,City,603797,321624,282173,82439,43543,38896,365347,208434,156913,877,893,70.08,74.95,64.50
09,UTTAR PRADESH,35,Jhansi,UA,549391,292497,256894,56230,30199,26031,416266,235174,181092,878,862,84.41,89.66,78.44
09,UTTAR PRADESH,02,Muzaffarnagar,UA,494792,261338,233454,64696,35120,29576,339129,190126,149003,893,842,78.85,84.05,73.08
09,UTTAR PRADESH,14,Mathura,UA,454937,244333,210604,56267,30495,25772,307427,177630,129797,862,845,77.11,83.07,70.22
09,UTTAR PRADESH,05,Rampur,UA,349062,182325,166737,41769,21742,20027,183011,100067,82944,915,921,59.56,62.31,56.54
09,UTTAR PRADESH,21,Shahjahanpur,UA,346103,183087,163016,38736,20602,18134,214573,120079,94494,890,880,69.81,73.90,65.22
09,UTTAR PRADESH,28,Farrukhabad,UA,290540,154630,135910,33944,18220,15724,193997,108989,85008,879,863,75.60,79.90,70.73
09,UTTAR PRADESH,61,Maunath Bhanjan,City,279060,143273,135787,40651,20820,19831,187382,102802,84580,948,952,78.60,83.95,72.94
09,UTTAR PRADESH,09,Hapur,City,262801,139694,123107,36714,19822,16892,170325,98394,71931,881,852,75.34,82.08,67.72
09,UTTAR PRADESH,46,Faizabad,UA,259160,139074,120086,25436,13341,12095,199700,112075,87625,863,907,85.44,89.14,81.14
09,UTTAR PRADESH,30,Etawah,City,256790,135829,120961,28922,15521,13401,188887,104612,84275,891,863,82.89,86.95,78.35
09,UTTAR PRADESH,68,Mirzapur,UA,245817,131534,114283,29619,15729,13890,168318,96834,71484,869,883,77.85,83.62,71.20
09,UTTAR PRADESH,11,Bulandshahr,UA,235310,123549,111761,30886,16966,13920,160203,90761,69442,905,820,78.37,85.16,70.97
09,UTTAR PRADESH,04,Sambhal,City,221334,116008,105326,34279,17702,16577,92608,51382,41226,908,936,49.51,52.27,46.45
09,UTTAR PRADESH,06,Amroha,City,197135,102804,94331,26855,13799,13056,108772,60621,48151,918,946,63.88,68.11,59.24
09,UTTAR PRADESH,24,Hardoi,UA,197046,104201,92845,21719,11528,10191,145999,81593,64406,891,884,83.27,88.04,77.92
09,UTTAR PRADESH,41,Fatehpur,City,193801,101620,92181,22078,11850,10228,133418,74561,58857,907,863,77.69,83.06,71.82
09,UTTAR PRADESH,27,Rae Bareli,City,191056,99844,91212,18866,9886,8980,142863,78519,64344,914,908,82.97,87.28,78.25
09,UTTAR PRADESH,34,Orai,UA,190625,101434,89191,20424,11075,9349,141856,81026,60830,879,844,83.35,89.67,76.19
09,UTTAR PRADESH,23,Sitapur,UA,188230,99129,89101,19721,10492,9229,139895,76643,63252,899,880,83.02,86.47,79.19
09,UTTAR PRADESH,49,Bahraich,City,186241,98529,87712,22828,12046,10782,122602,66544,56058,890,895,75.03,76.94,72.87
09,UTTAR PRADESH,09,Modinagar,UA,182811,97335,85476,21441,11898,9543,140441,79638,60803,878,802,87.03,93.21,80.07
09,UTTAR PRADESH,25,Unnao,City,178681,94080,84601,18604,9949,8655,134018,73411,60607,899,870,83.72,87.26,79.80
09,UTTAR PRADESH,63,Jaunpur,City,168128,88704,79424,18033,9449,8584,123245,68005,55240,895,908,82.11,85.81,77.98
09,UTTAR PRADESH,22,Lakhimpur,UA,164925,87908,77017,18174,9724,8450,122979,68190,54789,876,869,83.80,87.22,79.91
09,UTTAR PRADESH,13,Hathras,UA,161289,86028,75261,20279,11033,9246,110061,62404,47657,875,838,78.05,83.21,72.19
09,UTTAR PRADESH,39,Banda,UA,160432,85473,74959,18317,9670,8647,118826,67697,51129,877,894,83.61,89.31,77.10
09,UTTAR PRADESH,20,Pilibhit,UA,160146,84546,75600,16089,8415,7674,104149,57604,46545,894,912,72.30,75.66,68.52
09,UTTAR PRADESH,18,Budaun,City,159221,83475,75746,19613,10420,9193,101914,56012,45902,907,882,73.00,76.67,68.97
09,UTTAR PRADESH,65,Mughalsarai,UA,154692,81524,73168,19055,10078,8977,105904,60152,45752,898,891,78.08,84.19,71.27
09,UTTAR PRADESH,45,Barabanki,UA,146831,77766,69065,16093,8434,7659,106097,58608,47489,888,908,81.15,84.53,77.34
09,UTTAR PRADESH,11,Khurja,UA,142636,75384,67252,20072,10995,9077,84220,48765,35455,892,826,68.72,75.73,60.95
09,UTTAR PRADESH,52,Gonda,UA,138929,71475,67454,15608,8253,7355,99057,55067,43990,944,891,80.32,87.10,73.20
09,UTTAR PRADESH,17,Mainpuri,UA,133078,69788,63290,16371,8827,7544,99977,54592,45385,907,855,85.66,89.55,81.41
09,UTTAR PRADESH,36,Lalitpur,City,133041,69548,63493,16193,8413,7780,98108,55330,42778,913,925,83.96,90.50,76.78
09,UTTAR PRADESH,70,Etah,UA,131023,69446,61577,15890,8485,7405,98581,54794,43787,887,873,85.62,89.88,80.83
09,UTTAR PRADESH,59,Deoria,City,129570,67754,61816,13821,7243,6578,102802,56719,46083,912,908,88.81,93.73,83.43
09,UTTAR PRADESH,64,Ghazipur,UA,121136,63689,57447,13986,7488,6498,91049,50711,40338,902,868,84.97,90.23,79.17
09,UTTAR PRADESH,48,Sultanpur,UA,116211,61062,55149,12368,6577,5791,90980,49828,41152,903,880,87.61,91.45,83.37
09,UTTAR PRADESH,60,Azamgarh,UA,116165,60678,55487,13287,7136,6151,88748,48716,40032,914,862,86.27,90.99,81.14
09,UTTAR PRADESH,03,Bijnor,UA,115381,60656,54725,14499,7760,6739,78584,43122,35462,902,868,77.90,81.52,73.90
09,UTTAR PRADESH,54,Basti,City,114651,60126,54525,12568,6541,6027,87065,48473,38592,907,921,85.29,90.46,79.57
09,UTTAR PRADESH,04,Chandausi,City,114254,60238,54016,14417,7730,6687,72515,40323,32192,897,865,72.63,76.79,68.02
09,UTTAR PRADESH,47,Akbarpur,City,111594,57560,54034,14037,7247,6790,75062,42208,32854,939,937,76.94,83.89,69.54
09,UTTAR PRADESH,62,Ballia,UA,111287,59340,51947,11522,6145,5377,86442,48425,38017,875,875,86.65,91.03,81.63
09,UTTAR PRADESH,60,Mubarakpur,UA,109539,55946,53593,16147,8168,7979,64678,34825,29853,958,977,69.25,72.89,65.45
09,UTTAR PRADESH,10,Greater Noida,CT,107676,58662,49014,15517,8512,7005,79757,45878,33879,836,823,86.54,91.48,80.65
09,UTTAR PRADESH,16,Shikohabad,City,107300,57017,50283,12956,7106,5850,77060,43030,34030,882,823,81.68,86.21,76.59
09,UTTAR PRADESH,02,Shamli,City,107233,57236,49997,13724,7634,6090,76650,43469,33181,874,798,81.97,87.64,75.57
09,UTTAR PRADESH,08,Baraut,City,102733,54521,48212,13536,7387,6149,69559,39900,29659,884,832,77.98,84.65,70.51
09,UTTAR PRADESH,71,Kasganj,City,101241,53507,47734,13043,7139,5904,69289,38933,30356,892,827,78.56,83.97,72.57
10,BIHAR,28,Patna,UA,2046652,1087864,958788,239035,127866,111169,1519295,839640,679655,881,869,84.05,87.46,80.18
10,BIHAR,34,Gaya,UA,470839,249797,221042,59669,31323,28346,351365,197004,154361,885,905,85.45,90.17,80.11
10,BIHAR,22,Bhagalpur,UA,410210,218284,191926,55898,29081,26817,286125,160720,125405,879,922,80.76,84.95,75.95
10,BIHAR,14,Muzaffarpur,UA,393724,208509,185215,47784,25300,22484,294297,162629,131668,888,889,85.07,88.77,80.91
10,BIHAR,09,Purnia,UA,310817,163892,146925,45730,23519,22211,196272,111028,85244,896,944,74.04,79.09,68.35
10,BIHAR,13,Darbhanga,UA,306089,161346,144743,42213,22176,20037,213048,120206,92842,897,904,80.74,86.37,74.45
10,BIHAR,27,Biharsharif,City,296889,154915,141974,43646,22758,20888,189420,110247,79173,916,918,74.80,83.42,65.39
10,BIHAR,29,Arrah,City,261099,139319,121780,34419,18356,16063,189080,107822,81258,874,875,83.41,89.14,76.86
10,BIHAR,20,Begusarai,City,251136,133931,117205,37966,20012,17954,169161,96459,72702,875,897,79.35,84.67,73.25
10,BIHAR,10,Katihar,UA,240565,126834,113731,32824,16983,15841,166388,93641,72747,897,933,80.09,85.24,74.32
10,BIHAR,24,Munger,City,213101,113173,99928,29260,15323,13937,150435,84571,65864,883,910,81.83,86.43,76.59
10,BIHAR,17,Chapra,UA,212955,112280,100675,29133,15308,13825,148922,83270,65652,897,903,81.01,85.87,75.59
10,BIHAR,01,Bettiah,UA,156200,82663,73537,22067,11653,10414,108494,60463,48031,890,894,80.89,85.15,76.09
10,BIHAR,12,Saharsa,City,155175,82589,72586,24582,12814,11768,101425,58689,42736,879,918,77.66,84.11,70.27
10,BIHAR,32,Sasaram,City,147396,77687,69709,19363,10189,9174,105378,58900,46478,897,900,82.31,87.26,76.78
10,BIHAR,18,Hajipur,City,147126,78561,68565,20090,10694,9396,100691,57537,43154,873,879,79.26,84.78,72.93
10,BIHAR,32,Dehri,City,137068,72311,64757,18372,9570,8802,98968,56416,42552,896,920,83.38,89.92,76.05
10,BIHAR,16,Siwan,City,134458,70670,63788,17632,9440,8192,98898,56152,42746,903,868,84.65,91.71,76.89
10,BIHAR,02,Motihari,City,125183,67438,57745,16325,8891,7434,94926,52904,42022,856,836,87.20,90.36,83.52
10,BIHAR,35,Nawada,UA,118820,62361,56459,16475,8453,8022,83715,46497,37218,905,949,81.80,86.25,76.84
10,BIHAR,01,Bagaha,City,113012,59946,53066,19070,9802,9268,56998,34751,22247,885,946,60.67,69.30,50.79
10,BIHAR,30,Buxar,UA,110608,58228,52380,14938,7904,7034,80747,45435,35312,900,890,84.40,90.28,77.87
10,BIHAR,08,Kishanganj,City,107076,55688,51388,17017,8743,8274,67286,37482,29804,923,946,74.71,79.84,69.13
10,BIHAR,04,Sitamarhi,UA,105924,56526,49398,15032,8050,6982,71709,40592,31117,874,867,78.89,83.74,73.36
10,BIHAR,24,Jamalpur,City,105221,56231,48990,12298,6587,5711,81192,45961,35231,871,867,87.38,92.58,81.40
10,BIHAR,37,Jehanabad,City,102456,54868,47588,14516,7706,6810,70052,39889,30163,867,884,79.66,84.58,73.97
10,BIHAR,33,Aurangabad,City,101520,53307,48213,14292,7548,6744,75796,42338,33458,904,893,86.89,92.52,80.68
13,NAGALAND,05,Dimapur,City,123777,65017,58760,14438,7345,7093,95646,51604,44042,904,966,87.48,89.48,85.24
14,MANIPUR ,99,Imphal,UA,414288,201635,212653,43917,22542,21375,333588,170395,163193,1055,948,90.07,95.14,85.32
15,MIZORAM,03,Aizawl (NT),City,291822,143803,148019,35147,17667,17480,253588,125256,128332,1029,989,98.80,99.30,98.31
16,TRIPURA,01,Agartala,City,399688,199616,200072,33635,17341,16294,343633,174524,169109,1002,940,93.88,95.75,92.02
17,MEGHALAYA,06,Shillong,UA,354325,176591,177734,40494,20941,19553,287141,145730,141411,1006,934,91.50,93.63,89.40
18,ASSAM,23,Guwahati,UA,968549,505542,463007,87366,43537,43829,802946,429099,373847,916,1007,91.12,92.88,89.19
18,ASSAM,17,Silchar,UA,228985,115443,113542,21841,11212,10629,188609,97589,91020,984,948,91.05,93.63,88.44
18,ASSAM,11,Dibrugarh,UA,154019,79743,74276,13303,6829,6474,126297,67266,59031,931,948,89.75,92.25,87.06
18,ASSAM,13,Jorhat,UA,153249,79348,73901,13757,7076,6681,127192,67429,59763,931,944,91.18,93.30,88.91
18,ASSAM,06,Nagaon,UA,147137,74824,72313,15117,7555,7562,119907,64320,55587,966,1001,90.82,95.62,85.85
18,ASSAM,10,Tinsukia,UA,125637,67063,58574,11890,6266,5624,104558,56125,48433,873,898,91.92,92.32,91.47
18,ASSAM,07,Tezpur,UA,100477,52635,47842,9497,4849,4648,81077,44355,36722,909,959,89.12,92.82,85.02
19,WEST BENGAL,99,Kolkata,UA,14112536,7319682,6792854,1063394,546373,517021,11526635,6159091,5367544,928,946,88.33,90.93,85.53
19,WEST BENGAL,09,Asansol,UA,1243008,647831,595177,132560,69051,63509,888324,499532,388792,919,920,80.00,86.31,73.13
19,WEST BENGAL,99,Siliguri,UA,701489,359750,341739,72252,37355,34897,516297,278087,238210,950,934,82.05,86.26,77.63
19,WEST BENGAL,09,Durgapur,UA,581409,301700,279709,51930,26688,25242,464340,253051,211289,927,946,87.70,92.01,83.03
19,WEST BENGAL,09,Barddhaman,UA,347016,177055,169961,25069,12900,12169,285300,151395,133905,960,943,88.62,92.23,84.86
19,WEST BENGAL,06,English Bazar,UA,324237,175073,149164,44186,24262,19924,227726,123824,103902,852,821,81.32,82.11,80.39
19,WEST BENGAL,07,Baharampur,UA,305609,156489,149120,23182,11877,11305,249617,131561,118056,953,952,88.38,90.98,85.66
19,WEST BENGAL,11,Habra,UA,304584,154861,149723,23023,11864,11159,256313,134864,121449,967,941,91.03,94.31,87.65
19,WEST BENGAL,18,Kharagpur,UA,293719,150487,143232,25130,12923,12207,229952,124412,105540,952,945,85.61,90.44,80.55
19,WEST BENGAL,10,Santipur,UA,288718,147299,141419,24006,12303,11703,218828,117371,101457,960,951,82.67,86.94,78.21
19,WEST BENGAL,12,Dankuni,UA,249840,128139,121701,22956,11827,11129,194410,103668,90742,950,941,85.69,89.13,82.07
19,WEST BENGAL,07,Dhulian,UA,239022,119151,119871,45483,22981,22502,116233,63607,52626,1006,979,60.06,66.14,54.05
19,WEST BENGAL,10,Ranaghat,UA,235583,119578,116005,18575,9601,8974,186844,98723,88121,970,935,86.10,89.77,82.33
19,WEST BENGAL,19,Haldia,City,200762,104852,95910,21122,10799,10323,159984,88125,71859,915,956,89.06,93.70,83.96
19,WEST BENGAL,04,Raiganj,UA,199758,104966,94792,22028,11335,10693,145229,79076,66153,903,943,81.71,84.45,78.66
19,WEST BENGAL,10,Krishnanagar,UA,181182,91583,89599,13663,7095,6568,147565,76746,70819,978,926,88.09,90.84,85.29
19,WEST BENGAL,10,Nabadwip,UA,175474,90810,84664,13049,6741,6308,137367,74561,62806,932,936,84.57,88.69,80.15
19,WEST BENGAL,18,Medinipur,City,169127,85362,83765,14365,7259,7106,139303,72948,66355,981,979,90.01,93.40,86.56
19,WEST BENGAL,02,Jalpaiguri,UA,169013,85226,83787,14522,7441,7081,132911,69531,63380,983,952,86.03,89.39,82.63
19,WEST BENGAL,05,Balurghat,UA,164593,82466,82127,10349,5257,5092,141381,72831,68550,996,969,91.66,94.33,88.99
19,WEST BENGAL,11,Basirhat,UA,144891,73491,71400,12578,6495,6083,114952,60499,54453,972,937,86.88,90.30,83.37
19,WEST BENGAL,13,Bankura,City,138036,70734,67302,10760,5502,5258,111073,60272,50801,951,956,87.27,92.40,81.88
19,WEST BENGAL,10,Chakdaha,UA,132855,67135,65720,9829,4978,4851,111895,58405,53490,979,974,90.95,93.96,87.88
19,WEST BENGAL,01,Darjiling,UA,132016,65839,66177,7382,3862,3520,116126,59536,56590,1005,911,93.17,96.06,90.32
19,WEST BENGAL,02,Alipurduar,UA,127342,64898,62444,10545,5422,5123,104139,54714,49425,962,945,89.16,91.99,86.22
19,WEST BENGAL,14,Puruliya,UA,126894,65334,61560,12116,6221,5895,93578,52118,41460,942,948,81.53,88.17,74.48
19,WEST BENGAL,07,Jangipur,UA,122875,62734,60141,16299,8334,7965,80689,43428,37261,959,956,75.71,79.83,71.41
19,WEST BENGAL,11,Bongaon,City,110668,56416,54252,8452,4387,4065,92253,48799,43454,962,927,90.25,93.79,86.58
19,WEST BENGAL,03,Koch Bihar,UA,106760,53803,52957,7910,4053,3857,90698,47016,43682,984,952,91.75,94.50,88.97
20,JHARKHAND,99,Jamshedpur,UA,1337131,696858,640273,153872,81190,72682,1016910,562304,454606,919,895,85.94,91.33,80.09
20,JHARKHAND,09,Dhanbad,UA,1195298,633363,561935,151010,79216,71794,842117,486970,355147,887,906,80.64,87.88,72.46
20,JHARKHAND,19,Ranchi,UA,1126741,586634,540107,128541,67682,60859,882634,481976,400658,921,899,88.42,92.87,83.60
20,JHARKHAND,10,Bokaro Steel City,UA,563417,299232,264185,67672,36058,31614,420736,242827,177909,883,877,84.87,92.27,76.50
20,JHARKHAND,05,Deoghar,City,203116,108243,94873,25929,13907,12022,153807,87540,66267,876,864,86.80,92.80,79.98
20,JHARKHAND,10,Phusro,UA,186139,97665,88474,22125,11728,10397,131202,75847,55355,906,887,79.99,88.26,70.90
20,JHARKHAND,15,Hazaribag,UA,153599,80095,73504,17276,9108,8168,122881,66602,56279,918,897,90.14,93.82,86.14
20,JHARKHAND,04,Giridih,UA,143529,74841,68688,20658,10856,9802,101256,55951,45305,918,903,82.41,87.44,76.94
20,JHARKHAND,16,Ramgarh,UA,132441,70879,61562,17086,9082,8004,95714,55352,40362,869,881,82.97,89.57,75.36
20,JHARKHAND,13,Medini Nagar,UA,119972,63244,56728,13752,7199,6553,94361,52392,41969,897,910,88.84,93.48,83.65
20,JHARKHAND,09,Chirkunda,UA,118822,62394,56428,14742,7762,6980,80168,46038,34130,904,899,77.03,84.27,69.02
21,ORISSA,17,Bhubaneswar,UA,881988,468302,413686,79706,41875,37831,746162,407910,338252,883,903,93.00,95.66,90.00
21,ORISSA,12,Cuttack,UA,658986,331246,327740,53760,28089,25671,550935,295792,255143,989,914,91.03,97.57,84.47
21,ORISSA,05,Raurkela,UA,552970,291027,261943,56950,30088,26862,431080,239588,191492,900,893,86.91,91.82,81.46
21,ORISSA,19,Brahmapur Town,City,355823,185584,170239,29509,15544,13965,293818,159550,134268,917,898,90.04,93.83,85.92
21,ORISSA,03,Sambalpur,UA,269575,138826,130749,27510,14560,12950,207430,112937,94493,942,889,85.69,90.88,80.22
21,ORISSA,18,Puri Town,City,201026,104267,96759,17000,8939,8061,164481,88504,75977,928,902,89.38,92.84,85.66
21,ORISSA,08,Baleshwar,UA,177557,90750,86807,17911,9165,8746,138215,73888,64327,957,954,86.58,90.57,82.41
21,ORISSA,09,Bhadrak,UA,129152,66368,62784,14492,7449,7043,93121,50550,42571,946,945,81.21,85.80,76.37
21,ORISSA,07,Baripada,UA,116874,60535,56339,10688,5629,5059,93463,50763,42700,931,899,88.02,92.45,83.27
22,CHHATTISGARH,11,Raipur,UA,1122555,578339,544216,142826,73940,68886,846952,464669,382283,941,932,86.45,92.12,80.42
22,CHHATTISGARH,10,Durg-Bhilainagar,UA,1064077,545683,518394,116977,60601,56376,824189,451691,372498,950,930,87.02,93.12,80.62
22,CHHATTISGARH,07,Bilaspur,UA,452851,232995,219856,52550,27550,25000,349406,190934,158472,944,907,87.29,92.94,81.33
22,CHHATTISGARH,05,Korba,UA,365073,189466,175607,45529,23509,22020,269557,152566,116991,927,937,84.36,91.93,76.17
22,CHHATTISGARH,09,Rajnandgaon,City,163122,81873,81249,18677,9610,9067,127042,68134,58908,992,943,87.95,94.29,81.61
22,CHHATTISGARH,04,Raigarh,UA,149991,76898,73093,18344,9610,8734,114882,62892,51990,951,909,87.27,93.47,80.78
22,CHHATTISGARH,15,Jagdalpur,City,125345,63910,61435,13804,7192,6612,95303,51905,43398,961,919,85.44,91.51,79.16
22,CHHATTISGARH,02,Ambikapur,UA,123173,64130,59043,14172,7519,6653,95640,52351,43289,921,885,87.74,92.47,82.63
22,CHHATTISGARH,13,Dhamtari,UA,101645,50769,50876,11283,5780,5503,77655,41912,35743,1002,952,85.94,93.16,78.78
23,MADHYA PRADESH,22,Indore,UA,2167447,1129348,1038099,254108,134644,119464,1659399,909361,750038,919,887,86.73,91.42,81.65
23,MADHYA PRADESH,27,Bhopal,UA,1883381,985408,897973,217415,113516,103899,1420858,778192,642666,911,915,85.29,89.25,80.93
23,MADHYA PRADESH,34,Jabalpur,UA,1267564,663096,604468,128679,67630,61049,1015074,554214,460860,912,903,89.13,93.07,84.81
23,MADHYA PRADESH,04,Gwalior,UA,1101981,588752,513229,120347,65968,54379,835334,474648,360686,872,824,85.10,90.79,78.61
23,MADHYA PRADESH,18,Ujjain,City,515215,265291,249924,57630,30007,27623,391470,214481,176989,942,921,85.55,91.16,79.62
23,MADHYA PRADESH,10,Sagar,UA,370296,194659,175637,43835,22723,21112,293742,162354,131388,902,929,89.98,94.43,85.03
23,MADHYA PRADESH,20,Dewas,City,289438,150193,139245,34435,18117,16318,218877,122388,96489,927,901,85.83,92.66,78.49
23,MADHYA PRADESH,12,Satna,UA,283004,149460,133544,32066,17122,14944,216641,121772,94869,894,873,86.33,92.02,79.99
23,MADHYA PRADESH,17,Ratlam,UA,273892,139766,134126,29397,15295,14102,214892,115942,98950,960,922,87.89,93.15,82.44
23,MADHYA PRADESH,13,Rewa,City,235422,124634,110788,24234,13131,11103,185291,103599,81692,889,846,87.74,92.91,81.95
23,MADHYA PRADESH,33,Murwara (Katni),City,221875,115463,106412,25168,13299,11869,171966,94777,77189,922,892,87.42,92.77,81.64
23,MADHYA PRADESH,46,Singrauli,City,220295,117276,103019,29569,15438,14131,147527,87870,59657,878,915,77.35,86.28,67.11
23,MADHYA PRADESH,50,Burhanpur,City,210891,108234,102657,28107,14628,13479,149339,80909,68430,948,921,81.70,86.44,76.73
23,MADHYA PRADESH,49,Khandwa,City,200681,102873,97808,24079,12659,11420,153609,82575,71034,951,902,86.98,91.53,82.23
23,MADHYA PRADESH,02,Morena,City,200506,108405,92101,26454,14636,11818,139903,83531,56372,850,807,80.38,89.08,70.22
23,MADHYA PRADESH,03,Bhind,City,197332,105394,91938,24486,13319,11167,145530,83903,61627,872,838,84.20,91.12,76.30
23,MADHYA PRADESH,38,Chhindwara,UA,190008,97040,92968,19227,9885,9342,152429,81728,70701,958,945,89.25,93.77,84.54
23,MADHYA PRADESH,41,Guna,City,180978,94645,86333,23757,12658,11099,128463,73169,55294,912,877,81.71,89.24,73.50
23,MADHYA PRADESH,06,Shivpuri,City,179972,95227,84745,22683,12075,10608,124641,72107,52534,890,879,79.24,86.72,70.86
23,MADHYA PRADESH,26,Vidisha,City,155959,81424,74535,19360,10122,9238,118678,65802,52876,915,913,86.88,92.29,80.98
23,MADHYA PRADESH,08,Chhattarpur,UA,147688,78070,69618,18312,9874,8438,108806,60806,48000,892,855,84.10,89.16,78.46
23,MADHYA PRADESH,11,Damoh,UA,147515,76951,70564,17519,9161,8358,113014,62616,50398,917,912,86.94,92.37,81.02
23,MADHYA PRADESH,16,Mandsaur,City,141468,72370,69098,15721,8282,7439,109135,59436,49699,955,898,86.79,92.74,80.60
23,MADHYA PRADESH,23,Khargone,UA,133361,68672,64689,16662,8786,7876,96870,53275,43595,942,896,83.01,88.96,76.73
23,MADHYA PRADESH,15,Neemuch,UA,128575,67566,61009,15008,7836,7172,97528,55043,42485,903,915,85.88,92.15,78.91
23,MADHYA PRADESH,21,Pithampur,City,126099,70577,55522,20438,10872,9566,87417,54030,33387,787,880,82.73,90.49,72.65
23,MADHYA PRADESH,32,Hoshangabad,City,117956,61610,56346,13012,6964,6048,92317,50943,41374,915,868,87.97,93.22,82.26
23,MADHYA PRADESH,32,Itarsi,UA,114430,59382,55048,11832,6130,5702,92647,50702,41945,927,930,90.30,95.21,85.00
23,MADHYA PRADESH,28,Sehore,UA,109025,56397,52628,12869,6745,6124,82196,45012,37184,933,908,85.48,90.65,79.96
23,MADHYA PRADESH,30,Betul,City,103341,52902,50439,11005,5772,5233,83356,44429,38927,953,907,90.27,94.27,86.11
23,MADHYA PRADESH,39,Seoni,City,102377,52354,50023,10413,5467,4946,83832,44862,38970,955,905,91.16,95.68,86.45
23,MADHYA PRADESH,05,Datia,City,100466,52931,47535,12218,6553,5665,71071,40482,30589,898,864,80.54,87.29,73.06
23,MADHYA PRADESH,18,Nagda,City,100036,51410,48626,11053,5840,5213,72618,40765,31853,946,893,81.61,89.46,73.37
24,GUJARAT,99,Ahmadabad,UA,6352254,3348264,3003990,675284,364965,310319,5082338,2805134,2277204,897,850,89.53,94.03,84.54
24,GUJARAT,25,Surat,UA,4585367,2613841,1971526,545869,300970,244899,3593918,2143732,1450186,754,814,88.97,92.69,83.99
24,GUJARAT,19,Vadodara,UA,1817191,946280,870911,172923,93146,79777,1513883,814179,699704,920,856,92.07,95.43,88.44
24,GUJARAT,09,Rajkot,UA,1390933,731209,659724,145399,79486,65913,1100435,601688,498747,902,829,88.35,92.32,83.99
24,GUJARAT,14,Bhavnagar,UA,606282,315978,290304,63358,34463,28895,465722,257528,208194,919,838,85.78,91.48,79.64
24,GUJARAT,10,Jamnagar,UA,600411,313497,286914,59173,31786,27387,445206,244658,200548,915,862,82.26,86.85,77.27
24,GUJARAT,12,Junagadh,City,320250,164091,156159,27375,14651,12724,259563,139317,120246,952,868,88.63,93.23,83.83
24,GUJARAT,15,Anand,UA,286921,148801,138120,28745,15363,13382,240028,128241,111787,928,871,92.97,96.11,89.62
24,GUJARAT,23,Navsari,UA,282753,148588,134165,29683,15924,13759,226184,124176,102008,903,864,89.38,93.60,84.72
24,GUJARAT,08,Wadhwan,UA,253620,132252,121368,25725,13761,11964,194274,108729,85545,918,869,85.25,91.76,78.19
24,GUJARAT,01,Gandhidham,City,248705,132388,116317,31224,16352,14872,181253,104073,77180,879,909,83.34,89.69,76.08
24,GUJARAT,09,Morvi,UA,246008,128290,117718,29493,15775,13718,181566,101417,80149,918,870,83.86,90.14,77.07
24,GUJARAT,16,Nadiad,UA,225132,115971,109161,20825,11240,9585,180843,97601,83242,941,853,88.52,93.19,83.60
24,GUJARAT,21,Bharuch,UA,224210,115545,108665,20544,10758,9786,181090,96231,84859,940,910,88.92,91.83,85.82
24,GUJARAT,11,Porbandar,UA,217307,112280,105027,20760,11078,9682,167997,92193,75804,935,874,85.47,91.10,79.50
24,GUJARAT,04,Mahesana,UA,190189,100495,89694,17956,10203,7753,156697,86414,70283,893,760,90.98,95.71,85.77
24,GUJARAT,01,Bhuj,UA,187279,98214,89065,20715,10854,9861,144913,80353,64560,907,909,87.00,91.98,81.51
24,GUJARAT,12,Veraval,UA,184855,94208,90647,21024,11031,9993,127121,71818,55303,962,906,77.59,86.34,68.57
24,GUJARAT,24,Valsad,UA,170235,86882,83353,14190,7426,6764,145625,76121,69504,959,911,93.32,95.80,90.75
24,GUJARAT,24,Vapi,City,163605,94338,69267,19899,10618,9281,143706,83720,59986,734,874,100.00,100.00,100.00
24,GUJARAT,17,Godhra,UA,161925,83568,78357,19489,10193,9296,125859,68641,57218,938,912,88.36,93.55,82.85
24,GUJARAT,21,Anklesvar,UA,140839,75167,65672,15168,8137,7031,114184,62978,51206,874,864,90.86,93.95,87.32
24,GUJARAT,02,Palanpur,UA,140344,73342,67002,15698,8538,7160,108193,61232,46961,914,839,86.80,94.49,78.47
24,GUJARAT,03,Patan,UA,133744,69984,63760,13089,7053,6036,105998,59060,46938,911,856,87.85,93.85,81.31
24,GUJARAT,14,Botad,City,130302,67778,62524,16654,8889,7765,94563,53275,41288,922,874,83.21,90.47,75.40
24,GUJARAT,18,Dohad,UA,130255,66443,63812,17457,9135,8322,95726,52483,43243,960,911,84.86,91.58,77.93
24,GUJARAT,09,Jetpur Navagadh,City,118550,62331,56219,12295,6684,5611,89110,49677,39433,902,839,83.86,89.27,77.92
24,GUJARAT,13,Amreli,UA,118059,59990,58069,11042,6003,5039,95116,50278,44838,968,839,88.88,93.13,84.55
24,GUJARAT,09,Gondal,City,112064,58417,53647,11591,6358,5233,86139,47112,39027,918,823,85.73,90.50,80.61
24,GUJARAT,02,Deesa,City,111149,58724,52425,14192,7790,6402,78219,45479,32740,893,822,80.67,89.29,71.14
27,MAHARASHTRA,99,Greater Mumbai,UA,18414288,9894088,8520200,1743997,917855,826142,15132568,8423992,6708576,861,900,90.78,93.85,87.19
27,MAHARASHTRA,25,Pune,UA,5049968,2659484,2390484,561004,297943,263061,4103766,2243534,1860232,899,883,91.42,95.00,87.44
27,MAHARASHTRA,09,Nagpur,UA,2497777,1275750,1222027,248678,129522,119156,2095419,1102638,992781,958,920,93.17,96.20,90.02
27,MAHARASHTRA,20,Nashik,UA,1562769,824641,738128,177966,95924,82042,1259723,692426,567297,895,855,90.97,95.02,86.47
27,MAHARASHTRA,21,Vasai Virar City,City,1221233,649535,571698,137343,71716,65627,987916,548138,439778,880,915,91.15,94.86,86.90
27,MAHARASHTRA,19,Aurangabad,UA,1189376,620097,569279,154067,82867,71200,923128,505531,417597,918,859,89.16,94.10,83.84
27,MAHARASHTRA,30,Solapur,City,951118,482194,468924,104466,54728,49738,710180,390335,319845,972,909,83.88,91.31,76.30
27,MAHARASHTRA,21,Bhiwandi,UA,737411,434975,302436,91796,47483,44313,525930,326853,199077,695,933,81.46,84.35,77.12
27,MAHARASHTRA,07,Amravati,City,646801,330544,316257,62497,32713,29784,543568,284490,259078,957,910,93.03,95.52,90.44
27,MAHARASHTRA,20,Malegaon,UA,576425,293976,282449,90654,46822,43832,417635,221530,196105,961,936,85.97,89.63,82.18
27,MAHARASHTRA,34,Kolhapur,UA,561841,287376,274465,51157,27912,23245,470675,250000,220675,955,833,92.17,96.35,87.84
27,MAHARASHTRA,15,Nanded Waghala,City,550564,286152,264412,68181,36417,31764,421606,231449,190157,924,872,87.40,92.68,81.74
27,MAHARASHTRA,35,Sangali,UA,513862,260956,252906,52775,28179,24596,406145,217461,188684,969,873,88.08,93.42,82.64
27,MAHARASHTRA,03,Jalgaon,City,460468,241228,219240,51544,28548,22996,363778,198426,165352,909,806,88.96,93.30,84.26
27,MAHARASHTRA,05,Akola,City,427146,218184,208962,46500,24488,22012,347687,183594,164093,958,899,91.34,94.78,87.77
27,MAHARASHTRA,28,Latur,City,382754,198151,184603,45822,24773,21049,291226,160070,131156,932,850,86.43,92.32,80.19
27,MAHARASHTRA,26,Ahmadnagar,UA,379867,196344,183523,39836,21434,18402,311603,167369,144234,935,859,91.64,95.69,87.35
27,MAHARASHTRA,02,Dhule,City,376093,193854,182239,43677,23246,20431,298693,160511,138182,940,879,89.86,94.08,85.40
27,MAHARASHTRA,34,Ichalkaranji,UA,325709,169870,155839,37105,19642,17463,253731,140773,112958,917,889,87.92,93.71,81.63
27,MAHARASHTRA,13,Chandrapur,City,321036,165125,155911,30353,15921,14432,263962,142528,121434,944,906,90.81,95.53,85.83
27,MAHARASHTRA,17,Parbhani,City,307191,157628,149563,40075,21187,18888,225298,123760,101538,949,891,84.34,90.71,77.70
27,MAHARASHTRA,18,Jalna,City,285349,147714,137635,37695,19982,17713,209531,116300,93231,932,886,84.61,91.05,77.74
27,MAHARASHTRA,03,Bhusawal,UA,204016,105164,98852,21272,11499,9773,165435,88928,76507,940,850,90.53,94.94,85.89
27,MAHARASHTRA,24,Navi Mumbai Panvel Raigad (CT),CT,194999,107771,87228,25679,13633,12046,153608,88833,64775,809,884,90.72,94.36,86.16
27,MAHARASHTRA,24,Panvel,City,180464,93135,87329,17512,9213,8299,153138,80790,72348,938,901,93.98,96.27,91.54
27,MAHARASHTRA,31,Satara,UA,149170,75960,73210,14390,7610,6780,125327,65922,59405,964,891,92.99,96.45,89.42
27,MAHARASHTRA,27,Bid,City,146237,75655,70582,19580,10626,8954,112171,61135,51036,933,843,88.56,94.01,82.81
27,MAHARASHTRA,14,Yavatmal,UA,138464,69858,68606,12968,6902,6066,115855,60334,55521,982,879,92.32,95.84,88.78
27,MAHARASHTRA,09,Kamptee,UA,136124,70375,65749,14846,7625,7221,109241,59505,49736,934,947,90.07,94.83,84.98
27,MAHARASHTRA,11,Gondiya,City,132889,66756,66133,12835,6652,6183,112490,58721,53769,991,929,93.70,97.70,89.69
27,MAHARASHTRA,30,Barshi,City,118573,60857,57716,13029,7060,5969,91260,49965,41295,948,845,86.47,92.88,79.80
27,MAHARASHTRA,07,Achalpur,City,112293,58256,54037,11810,6186,5624,92433,49347,43086,928,909,91.99,94.77,89.00
27,MAHARASHTRA,29,Osmanabad,City,112085,58098,53987,13346,7184,6162,87041,47577,39464,929,858,88.15,93.45,82.52
27,MAHARASHTRA,01,Nandurbar,City,111067,57543,53524,12621,6868,5753,85635,46673,38962,930,838,86.99,92.10,81.56
27,MAHARASHTRA,08,Wardha,City,105543,53241,52302,9754,5139,4615,90091,46752,43339,982,898,94.05,97.19,90.88
27,MAHARASHTRA,28,Udgir,City,104063,54445,49618,13075,6933,6142,78051,43518,34533,911,886,85.78,91.59,79.43
27,MAHARASHTRA,08,Hinganghat,City,100416,51881,48535,9681,5175,4506,85599,45728,39871,936,871,94.34,97.91,90.56
28,ANDHRA PRADESH,99,Hyderabad ,UA,7749334,3985240,3764094,831435,427973,403462,5736575,3064389,2672186,945,943,82.92,86.14,79.51
28,ANDHRA PRADESH,13,GVMC,City,1730320,875199,855121,158924,81119,77805,1298896,698959,599937,977,959,82.66,88.02,77.18
28,ANDHRA PRADESH,99,Vijayawada ,UA,1491202,750770,740432,133396,68180,65216,1107903,584005,523898,986,957,81.60,85.56,77.59
28,ANDHRA PRADESH,09,Warangal,UA,759594,380833,378761,67732,34812,32920,571229,312338,258891,995,946,82.56,90.27,74.86
28,ANDHRA PRADESH,17,Guntur,UA,673952,333894,340058,61560,31396,30164,494287,259893,234394,1018,961,80.71,85.92,75.64
28,ANDHRA PRADESH,19,Nellore,UA,564148,286070,278078,48393,24802,23591,425632,226196,199436,972,951,82.53,86.58,78.37
28,ANDHRA PRADESH,14,Rajahmundry,UA,478199,236489,241710,42968,21709,21259,359051,185660,173391,1022,979,82.50,86.44,78.65
28,ANDHRA PRADESH,21,Kurnool,UA,478124,239401,238723,50240,25977,24263,331039,177841,153198,997,934,77.37,83.33,71.43
28,ANDHRA PRADESH,23,Tirupati,UA,459985,231456,228529,41589,21645,19944,356558,190414,166144,987,921,85.22,90.76,79.65
28,ANDHRA PRADESH,14,Kakinada,UA,442936,217573,225363,39464,19972,19492,329207,168326,160881,1036,976,81.59,85.18,78.15
28,ANDHRA PRADESH,20,Kadapa,UA,344078,172969,171109,36543,19001,17542,244011,132721,111290,989,923,79.34,86.20,72.47
28,ANDHRA PRADESH,22,Anantapur,UA,341895,172414,169481,32199,16967,15232,246757,134843,111914,983,898,79.68,86.75,72.55
28,ANDHRA PRADESH,02,Nizamabad,City,310467,155163,155304,34256,17408,16848,221829,119603,102226,1001,968,80.31,86.82,73.83
28,ANDHRA PRADESH,03,Karimnagar,UA,299660,151306,148354,28954,14879,14075,229903,124236,105667,980,946,84.93,91.06,78.69
28,ANDHRA PRADESH,10,Khammam,UA,262309,129937,132372,24419,12655,11764,196478,103140,93338,1019,930,82.59,87.94,77.39
28,ANDHRA PRADESH,03,Ramagundam,UA,252261,128347,123914,18643,9789,8854,174893,97804,77089,965,904,74.86,82.49,67.00
28,ANDHRA PRADESH,15,Eluru,UA,250693,123747,126946,21318,10670,10648,174273,89357,84916,1026,998,75.98,79.02,73.02
28,ANDHRA PRADESH,12,Vizianagaram,UA,239374,117412,121962,21665,11089,10576,177233,93420,83813,1039,954,81.41,87.86,75.25
28,ANDHRA PRADESH,20,Proddatur,UA,217895,108986,108909,21616,11106,10510,147156,81781,65375,999,946,74.97,83.55,66.44
28,ANDHRA PRADESH,21,Nandyal,UA,211787,106034,105753,21534,11245,10289,145471,79195,66276,997,915,76.46,83.55,69.43
28,ANDHRA PRADESH,07,Mahbubnagar,UA,210143,106232,103911,22299,11538,10761,155626,84590,71036,978,933,82.85,89.33,76.26
28,ANDHRA PRADESH,18,Ongole,UA,206419,103541,102878,19126,9903,9223,156217,83584,72633,994,931,83.41,89.26,77.55
28,ANDHRA PRADESH,21,Adoni,UA,184771,92006,92765,20517,10455,10062,112151,62646,49505,1008,962,68.28,76.82,59.86
28,ANDHRA PRADESH,23,Madanapalle,UA,179267,89692,89575,18062,9312,8750,128467,69340,59127,999,940,79.69,86.27,73.15
28,ANDHRA PRADESH,23,Chittoor,UA,175640,87480,88160,15758,8288,7470,136815,72208,64607,1008,901,85.57,91.18,80.07
28,ANDHRA PRADESH,16,Machilipatnam,City,170008,83561,86447,13778,7076,6702,130173,66337,63836,1035,947,83.32,86.73,80.05
28,ANDHRA PRADESH,17,Tenali,City,164649,81324,83325,13040,6630,6410,125275,64968,60307,1025,967,82.63,86.98,78.41
28,ANDHRA PRADESH,01,Mancherial,UA,163875,83961,79914,13150,6890,6260,114119,64092,50027,952,909,75.71,83.16,67.92
28,ANDHRA PRADESH,18,Chirala,UA,162725,80215,82510,14744,7512,7232,114435,61365,53070,1029,963,77.33,84.41,70.50
28,ANDHRA PRADESH,08,Nalgonda,UA,153736,77088,76648,15487,7922,7565,117035,62180,54855,994,955,84.66,89.90,79.40
28,ANDHRA PRADESH,22,Hindupur,City,151835,76625,75210,16309,8263,8046,103538,56177,47361,982,974,76.40,82.18,70.52
28,ANDHRA PRADESH,15,Bhimavaram,UA,147056,72457,74599,12520,6327,6193,112424,57519,54905,1030,979,83.56,86.98,80.26
28,ANDHRA PRADESH,11,Srikakulam,UA,146988,73077,73911,12741,6599,6142,115061,60953,54108,1011,931,85.71,91.69,79.84
28,ANDHRA PRADESH,01,Adilabad,UA,139103,70403,68700,15390,7918,7472,99158,54673,44485,976,944,80.15,87.50,72.65
28,ANDHRA PRADESH,22,Guntakal,City,126479,62695,63784,12614,6495,6119,86197,47471,38726,1017,942,75.70,84.47,67.16
28,ANDHRA PRADESH,22,Dharmavaram,City,121992,62186,59806,11963,6441,5522,79037,45025,34012,962,857,71.83,80.77,62.66
28,ANDHRA PRADESH,10,Kothagudem,UA,119450,58652,60798,10128,5160,4968,89496,47605,41891,1037,963,81.86,88.99,75.03
28,ANDHRA PRADESH,16,Gudivada,City,118289,58941,59348,9952,5081,4871,89009,46529,42480,1007,959,82.16,86.39,77.98
28,ANDHRA PRADESH,17,Narasaraopet,UA,117568,59514,58054,10519,5420,5099,84889,46228,38661,975,941,79.30,85.46,73.01
28,ANDHRA PRADESH,04,Siddipet,UA,113893,56600,57293,11396,5867,5529,81022,44870,36152,1012,942,79.05,88.44,69.84
28,ANDHRA PRADESH,22,Tadpatri,City,108249,54027,54222,11325,5813,5512,69948,39781,30167,1004,948,72.17,82.51,61.93
28,ANDHRA PRADESH,08,Suryapet,UA,106524,52800,53724,9511,4895,4616,82268,43655,38613,1018,943,84.80,91.13,78.63
28,ANDHRA PRADESH,08,Miryalaguda,UA,104956,52610,52346,10572,5432,5140,77557,42147,35410,995,946,82.17,89.34,75.01
28,ANDHRA PRADESH,03,Jagtial,UA,103962,51819,52143,10068,5131,4937,73882,40769,33113,1006,962,78.69,87.32,70.15
28,ANDHRA PRADESH,15,Tadepalligudem,UA,103703,51236,52467,9061,4667,4394,78656,40331,38325,1024,942,83.11,86.60,79.72
28,ANDHRA PRADESH,17,Chilakaluripet,City,101550,50201,51349,9525,4916,4609,66336,36472,29864,1023,938,72.08,80.54,63.89
29,KARNATAKA,18,BANGALORE,UA,8499399,4441248,4058151,870743,448965,421778,6832072,3697180,3134892,914,939,89.56,92.61,86.21
29,KARNATAKA,23,Mysore,UA,983893,493692,490201,86527,44527,42000,779537,404466,375071,993,943,86.87,90.05,83.68
29,KARNATAKA,08,Hubli-Dharwad,City,943857,475980,467877,99989,51293,48696,736506,389290,347216,983,949,87.28,91.67,82.83
29,KARNATAKA,21,Mangalore,UA,619664,307624,312040,55396,28640,26756,528511,269031,259480,1014,934,93.66,96.43,90.95
29,KARNATAKA,01,Belgaum,UA,610189,309689,300500,63519,32909,30610,491604,260796,230808,970,930,89.93,94.23,85.52
29,KARNATAKA,25,Gulbarga,UA,541617,277357,264260,70184,36614,33570,394133,214591,179542,953,917,83.60,89.14,77.83
29,KARNATAKA,13,Davanagere,City,435128,220544,214584,44545,22888,21657,331551,175747,155804,973,946,84.89,88.92,80.76
29,KARNATAKA,11,Bellary,City,409644,206026,203618,49587,25337,24250,281768,153275,128493,988,957,78.26,84.83,71.64
29,KARNATAKA,03,Bijapur,City,326360,165122,161238,39134,20482,18652,239631,128615,111016,976,911,83.43,88.92,77.86
29,KARNATAKA,14,Shimoga,City,322428,161978,160450,31626,16130,15496,255971,133191,122780,991,961,88.02,91.32,84.70
29,KARNATAKA,17,Tumkur,City,305821,155406,150415,29655,15233,14422,237424,123904,113520,968,947,85.97,88.39,83.47
29,KARNATAKA,05,Raichur,City,232456,117408,115048,27924,14286,13638,158452,86973,71479,980,955,77.47,84.34,70.49
29,KARNATAKA,04,Bidar,UA,213593,110279,103314,25275,13189,12086,164857,90100,74757,937,916,87.54,92.80,81.95
29,KARNATAKA,11,Hospet,City,206159,102923,103236,26478,13508,12970,143776,77678,66098,1003,960,80.02,86.87,73.23
29,KARNATAKA,20,Hassan,UA,173134,86335,86799,16283,8388,7895,141921,72627,69294,1005,941,90.48,93.17,87.82
29,KARNATAKA,07,Gadag,City,172813,86165,86648,18419,9519,8900,132094,70035,62059,1006,935,85.56,91.37,79.82
29,KARNATAKA,27,Robertson Pet,UA,165463,81927,83536,14966,7480,7486,134734,69400,65334,1020,1001,89.53,93.22,85.91
29,KARNATAKA,15,Udupi,UA,165401,81940,83461,13408,6944,6464,142143,72244,69899,1019,931,93.52,96.33,90.78
29,KARNATAKA,14,Bhadravati,City,150776,75020,75756,14000,7087,6913,118446,62199,56247,1010,975,86.60,91.56,81.70
29,KARNATAKA,12,Chitradurga,UA,145580,73193,72387,14843,7623,7220,116102,60714,55388,989,947,88.81,92.59,84.99
29,KARNATAKA,27,Kolar,City,138553,70064,68489,15993,8055,7938,102978,54121,48857,978,985,84.02,87.28,80.69
29,KARNATAKA,19,Mandya,City,137735,68748,68987,13269,6826,6443,105938,55442,50496,1003,944,85.11,89.54,80.74
29,KARNATAKA,16,Chikmagalur,City,118496,58859,59637,10931,5599,5332,96586,49742,46844,1013,952,89.79,93.39,86.26
29,KARNATAKA,06,Gangawati,UA,114459,57228,57231,14251,7281,6970,76473,42315,34158,1000,957,76.31,84.72,67.96
29,KARNATAKA,02,Bagalkot,City,112068,56837,55231,12399,6476,5923,85860,46623,39237,972,915,86.15,92.58,79.58
29,KARNATAKA,10,Ranibennur,City,106365,53933,52432,11572,5982,5590,85298,43234,42064,972,934,89.98,90.16,89.80
30,GOA,01,Panaji,UA,114405,59379,55026,10996,6057,4939,93995,50447,43548,927,815,90.90,94.61,86.94
30,GOA,02,Margao,UA,106528,54720,51808,10393,5327,5066,86538,45967,40571,947,951,90.02,93.06,86.80
30,GOA,02,Mormugao,UA,101068,53585,47483,10293,5507,4786,81733,45422,36311,886,869,90.04,94.48,85.04
32,KERALA,08,Kochi,UA,2117990,1042809,1075181,189586,96960,92626,1858505,924453,934052,1031,955,96.38,97.74,95.06
32,KERALA,04,Kozhikode,UA,2030519,966138,1064381,208665,106289,102376,1739745,839616,900129,1102,963,95.49,97.65,93.57
32,KERALA,07,Thrissur,UA,1854783,876049,978734,170591,87747,82844,1620100,769142,850958,1117,944,96.19,97.57,94.98
32,KERALA,05,Malappuram,UA,1698645,809154,889491,230527,117782,112745,1388426,668922,719504,1099,957,94.57,96.75,92.63
32,KERALA,14,Thiruvananthapuram,UA,1687406,815200,872206,142242,72164,70078,1440731,704926,735805,1070,971,93.24,94.87,91.73
32,KERALA,02,Kannur,UA,1642892,757769,885123,172924,87985,84939,1414524,657217,757307,1168,965,96.23,98.12,94.64
32,KERALA,13,Kollam,UA,1110005,529838,580167,101361,51856,49505,940840,455919,484921,1095,955,93.28,95.38,91.38
32,KERALA,11,Cherthala,UA,455408,222398,233010,39179,20156,19023,399809,198180,201629,1048,944,96.06,97.99,94.22
32,KERALA,11,Kayamkulam,UA,427091,197960,229131,35039,18022,17017,374043,174685,199358,1157,944,95.41,97.08,93.99
32,KERALA,10,Kottayam,UA,357533,174465,183068,28707,14612,14095,305069,149184,155885,1049,965,92.78,93.33,92.25
32,KERALA,06,Palakkad,UA,293566,143650,149916,26773,13707,13066,245829,123892,121937,1044,953,92.14,95.34,89.10
32,KERALA,11,Alappuzha,UA,241072,116401,124671,21638,11162,10476,210909,102817,108092,1071,939,96.12,97.70,94.66
32,KERALA,06,Ottappalam,UA,238238,114183,124055,25631,13060,12571,200647,97477,103170,1086,963,94.37,96.39,92.54
32,KERALA,01,Kanhangad,UA,229706,106983,122723,25483,12980,12503,188743,90325,98418,1147,963,92.42,96.09,89.29
32,KERALA,01,Kasaragod,UA,192761,92960,99801,24584,12621,11963,154740,76527,78213,1074,948,92.01,95.26,89.04
32,KERALA,10,Changanassery,UA,127971,61740,66231,11118,5700,5418,114394,55188,59206,1073,951,97.90,98.48,97.36
32,KERALA,07,Chalakudy,UA,114901,55276,59625,10176,5225,4951,100977,48815,52162,1079,948,96.42,97.53,95.41
32,KERALA,08,Kothamangalam,UA,114574,56753,57821,11255,5834,5421,98398,49412,48986,1019,929,95.24,97.04,93.48
33,TAMIL NADU,99,Chennai,UA,8696010,4389200,4306810,816862,416238,400624,7118747,3717302,3401445,981,962,90.35,93.57,87.08
33,TAMIL NADU,31,Coimbatore,UA,2151466,1077812,1073654,193497,98499,94998,1747178,912408,834770,996,964,89.23,93.17,85.30
33,TAMIL NADU,22,Madurai,UA,1462420,732861,729559,132904,68026,64878,1210645,630962,579683,995,954,91.06,94.91,87.21
33,TAMIL NADU,13,Tiruchirappalli,UA,1021717,507180,514537,89176,45321,43855,850484,437399,413085,1015,968,91.20,94.70,87.76
33,TAMIL NADU,32,Tiruppur,UA,962982,489465,473517,101797,52005,49792,742982,399561,343421,967,957,86.27,91.34,81.05
33,TAMIL NADU,07,Salem,UA,919150,463267,455883,82073,42024,40049,700821,374420,326401,984,953,83.72,88.88,78.49
33,TAMIL NADU,09,Erode,UA,521776,261470,260306,47029,24002,23027,403496,214981,188515,996,959,84.99,90.53,79.45
33,TAMIL NADU,27,Tirunelveli,UA,498984,246710,252274,46335,23677,22658,411281,211727,199554,1023,957,90.86,94.93,86.91
33,TAMIL NADU,04,Vellore,UA,481966,239735,242231,45049,22889,22160,381382,200068,181314,1010,968,87.29,92.26,82.39
33,TAMIL NADU,26,Thoothukkudi,UA,410760,205459,205301,42756,21596,21160,338949,174381,164568,999,980,92.10,94.84,89.37
33,TAMIL NADU,11,Dindigul,UA,292132,145438,146694,26169,13327,12842,236961,123409,113552,1009,964,89.10,93.41,84.83
33,TAMIL NADU,19,Thanjavur,UA,290724,142765,147959,24760,12778,11982,243017,123561,119456,1036,938,91.37,95.06,87.85
33,TAMIL NADU,04,Ranipet,UA,262346,129884,132462,26109,13406,12703,203977,106997,96980,1020,948,86.34,91.86,80.98
33,TAMIL NADU,24,Sivakasi,UA,234688,116869,117819,23183,11760,11423,176698,94563,82135,1008,971,83.54,89.97,77.20
33,TAMIL NADU,12,Karur,UA,233763,116536,117227,21175,11002,10173,187223,99007,88216,1006,925,88.07,93.82,82.40
33,TAMIL NADU,10,Udhagamandalam,UA,233374,115294,118080,18643,9333,9310,193689,100742,92947,1024,998,90.20,95.07,85.45
33,TAMIL NADU,30,Hosur,UA,229507,118133,111374,27724,14147,13577,178048,95487,82561,943,960,88.24,91.83,84.42
33,TAMIL NADU,28,Nagercoil,City,224329,110132,114197,19034,9599,9435,195748,97545,98203,1037,983,95.35,97.03,93.74
33,TAMIL NADU,03,Kancheepuram,UA,221749,110800,110949,19835,10022,9813,175561,92669,82892,1001,979,86.95,91.95,81.96
33,TAMIL NADU,08,Kumarapalayam,UA,194992,98642,96350,16613,8465,8148,132764,73805,58959,977,963,74.43,81.84,66.85
33,TAMIL NADU,21,Karaikkudi,UA,181347,90502,90845,16830,8582,8248,148458,77453,71005,1004,961,90.24,94.55,85.97
33,TAMIL NADU,16,Neyveli,UA,178925,90350,88575,13657,7201,6456,144512,77473,67039,980,897,87.44,93.17,81.64
33,TAMIL NADU,16,Cuddalore,City,173361,85593,87768,15940,8153,7787,139388,72083,67305,1025,955,88.54,93.08,84.15
33,TAMIL NADU,19,Kumbakonam,UA,167098,82844,84254,14552,7309,7243,139008,71612,67396,1017,991,91.13,94.81,87.51
33,TAMIL NADU,05,Tiruvannamalai,City,144683,72351,72332,14530,7413,7117,106256,55585,50671,1000,960,81.64,85.60,77.70
33,TAMIL NADU,31,Pollachi,UA,135235,67260,67975,11031,5683,5348,109900,57352,52548,1011,941,88.48,93.14,83.91
33,TAMIL NADU,24,Rajapalayam,City,130119,64624,65495,10504,5371,5133,103172,54622,48550,1013,956,86.25,92.18,80.43
33,TAMIL NADU,04,Gudiyatham,UA,124274,61564,62710,11876,6014,5862,95231,50296,44935,1019,975,84.73,90.54,79.04
33,TAMIL NADU,20,Pudukkottai,City,117215,58601,58614,10853,5566,5287,98054,50798,47256,1000,950,92.19,95.78,88.62
33,TAMIL NADU,04,Vaniyambadi,UA,116712,57746,58966,13898,7139,6759,86835,45118,41717,1021,947,84.46,89.15,79.91
33,TAMIL NADU,04,Ambur,City,113856,56052,57804,12150,6216,5934,88309,45439,42870,1031,955,86.83,91.18,82.65
33,TAMIL NADU,17,Nagapattinam,City,102838,50809,52029,11308,5858,5450,81913,42374,39539,1024,930,89.49,94.27,84.89
34,PUDUCHERRY,02,Puducherry,UA,654392,321834,332558,63879,32359,31520,526252,272575,253677,1033,974,89.12,94.16,84.27
35,ANDAMAN & NICOBAR ISLANDS,03,Port Blair,City,100608,53247,47361,9358,4852,4506,81908,44908,37000,889,929,89.76,92.79,86.34
